111111111
10000C001
100CCCC01
1000EP111
111111111