111111111
1000EPC11
111110011
111111111