11111111
1EP00001
100C0001
10000001
10000001
11111111