11111111
1P1C0001
10100001
10100101
10100101
10000101
1000C1E1
11111111