11111111111
1P100010001
10101010101
10101010101
10101010101
10101010101
10101010101
101010101C1
100010001E1
11111111111