1111111111
1CCCCCCCC1
1C1CCCCCC1
1CP1CCCCE1
1C1CCCCCC1
1CCCCCCCC1
1111111111