11111111111111111111111111111111111111111
11111111111111111111111111111111111111111
11111111111111111111111111111111111111111
11111111111111111111111111111111111111111
1111P000000000000000000000000000000001111
11110000000000000000000000000000000001111
11110000000000000000000000000000000001111
11110000000000000000000000000000000001111
11110000000000000000000000000000000001111
11110000000000000000000000000000000001111
11110000000000000000000000000000000001111
11110000000000000000000000000000000001111
11110000000000000000000000000000000001111
11110000000000000000000000000000000001111
11110000000000000000000000000000000001111
11110000000000000000000000000000000001111
11110000000000000000000000000000000001111
11110000000000000000000000000000000001111
111100000000000000000000000000000000E1111
11111111111111111111111111111111111111111
11111111111111111111111111111111111111111
11111111111111111111111111111111111111111
11111111111111111111111111111111111111111
